{
    "0": 1,
    "1": 2,
    "2": 3,
    "3": 4,
    "4": 5,
    "5": 6,
    "6": 10,
    "7": 7,
    "8": 8,
    "9": 11,
    "10": 13,
    "11": 12,
    "12": 14,
    "13": 15,
    "14": 16,
    "15": 17,
    "16": 18,
    "17": 19,
    "18": 20,
    "19": 36,
    "20": 21,
    "21": 22,
    "22": 24,
    "23": 23,
    "24": 25,
    "25": 27,
    "26": 26,
    "27": 28,
    "28": 29,
    "29": 33,
    "30": 35,
    "31": 32,
    "32": 30
}